architetto|arch
arciprete
avvocato|avv
barone|bne|b.ne
baronessa|bnssa|bn.ssa
capitano|cap
caporale
caporale maggiore
cardinale|card
cavaliere|cav
cavaliere ufficiale|cav uff
colonnello|col
commendatore|comm
console|cons
conte
contessa
corpo d'armata|corpo darmata|cda|c.d.a.|c.d.a|c d a
curato
don
donna
dottore|dott|dr
dottoressa|dottssa|dott.ssa|drssa|dr.ssa
duca
duchessa
egregio|egr
emissario|emiss.o
gentile
gentili
generale|gen
generali|gen.li
grande ufficiale|gr uff
giudice
imperatore
imperatrice
ingegnere|ing
maestra
maestro
maggiore|magg
marchesa
marchese
maresciallo|mar
ministero|ministro|min
monsignore|mons
onorevole|on
presidente|pres
presidente emerito|pres emerito
prete
prevosto
professore|prof
professoressa|profssa|prof.ssa
re
regina
reverendo|rev
reverendo madre|rm|r.m.|r.m|r m
reverendo padre|rp|r.p.|r.p|r p
san|s
sant'
santa|s
santi|ss|s.s|s.s.|s s
santo|s
santo padre|sp|s.p.|s.p|s p
senatore|sen
sergente|serg
signora|sigra|sig.ra
signore|sig
signori|sigg
signorina|signa|sig.na
sottotenente|sten|s.ten
tenente|ten
tenente colonnello|ten col
visconte
viscontessa