baron
broeder|br
burgermeester|burg|bgm
commandant|cmdt
dokter|dr
dominee|ds
gebroeders|gebr
generaal|gen
ingenieur|ir
jonkheer|jhr
kolonel|kol
kardinaal|kard
kort|k
korte|kte
koning|kon
koningin|kon
luitenant|luit
meester|mr
mejuffrouw|mej
mevrouw|mevr
minister|min
monseigneur|mgr
onze lieve vrouwe|onzelievevrouwe|olv|o l v
pastoor|past
pater
president|pres
prins|pr
prinses|prs
professor|prof
sint|st
vrouwe|vr
zuster|zr