accesso|acc.so|accso
alto|alt
alzaia|alz
androna|and
angolo|ang.|ang
arco|arc
autostrada|aut.da|autda|aut
audostradale|aut.sle|autsle|aut sle|aut.ale|autale
autostrade|aut.de|autde
baluardo|bdo
banchina|bna
bivio|biv
borgata|bga
borgo|b.go|bgo
bretella|br.lla|brlla
bretelle|br.lle|brlle
brigata|bgt
calata|clt
calle|cal
campiello|cpl
campo|c.po|cpo
canale|cnl
cantone|cat
casale|cas
cascina|c.na|cna
cavalcavia|cavalc.a|cavalca
chiusa|c.usa|cusa
circonvallazione|circonv.e|circonve|crv
contrà|con|contra'
contrada|contr.a|contra|c.da|cda|cnt
corso|c.so|cso
corte|c.te|cte
cortile|c.ile|ctile|c.le|cle
cortina|ctn
costa|cta
crocevia|cra
cupa|cup
discesa|dis
ferrata|f.rata|frata
fondamenta|f.ta|fta|fon
fondo|fdo
forca|f.ca|fca
forcella|forc.la|forcla
foro|for
frazione|fraz.e|fraze|frz|fraz
frazioni|fraz.i|frazi
galleria|gall.a|galla|gal
gallerie|gall.e|galle
genna|g.na|gna
genne|g.ne|gne
gradini|grd
interrato|int
larghetto|lgt
largo|l.go|lgo
logge|lge
lungadige|lgd
lungargine|lug
lungarno|lno
lungo|lun
lungolago|llg
lungomare|lre
lungotevere|lgv
località|localita|loc|loc.ta|locta
molo|mlo
monte|mte
passaggio|pas
passeggiata|pss
piazza|p.za|p.zza|pza|pzza
piazzale|p.le|ple
piazzetta|p.ta|pta|pzt
ponte|p.te|pte
pontile|ptl
porta|p.ta|pta
portici|prt
portico|pro
presso|pre
prolungamento|plg
provinciale
quartiere|qua
rampa|rpa
rampe|rpe
regione|reg
rio|rii
rio terà|rit|rio tera'
ripa|ri
riva|rva
riviera|riv
rotabile|rtb
rotonda|rtd
sacca|scc
salita|sal
salizada|s.da|sda
scala|scl
scale|sce
scali|sci
scalinata|sca
sdrucciolo|sdr
sestiere|ses
sottopassaggio|sps
spadaria|spd
spalto|spa
stazione|staz|sta
strada|s|str.a|stra|str
strada comunale|sc|s.c.|s.c|s c|stc
strada nuova|snu
strada provinciale|sp|s.p.|s.p|s p|str provinciale|s provinciale|str.prov|str prov|s.prov|s prov|stp
strada privata|spr
strada regionale|sr|s.r.|s.r|s r|str.reg|str reg|str r|str.r|str reginale|s reginale
strada statale|ss|s.s.|s.s|s s|str.s|str s|str.st|str st|str statale|s statale|sts
strada vecchia|sve
strada vicinale|sv|s.v.|s.v|s v|str.vic|str vic|str vicinale|s vicinale|svc
stradale|sdl
stradello|stl
stradetta|stt
stradone|std
stretta|str.ta|strta
strette|str.te|strte
stretti|str.ti|strti
stretto|str.to|strto|sto
superstrada
supportico|sup
tangenziale
traversa|tra
traversa nuova|tnu
traversa privata|tpr
traversa strada statale|tra s.s.
traversa vicinale|tvc
varco|var
via|v
via comunale|vc|v.c.|v.c|v c|vcm
via nuova|vnu
via privata|vpr
via provincale|vp|v.p.|v.p|v p|v provinciale|vpv
via statale|vs|v.s.|v.s|v s
via vecchia|vve
via vicinale|vvc
viale|v.le|vle|vl
viale privato|vlp
vicoletto|vct
vicolo|v.lo|vlo
vicolo largo|vcl
vicolo privato|vcp
vicolo nuovo|vcn
vicolo vecchio|vcv
vico|vic
villa|vla
villaggio|vil
viuzzo|vzo
vocabolo|voc
volta|vta
zona industriale|zin|z.i.
