acres|acrs
access|accs
alley|aly|ally|alee
alleyway|alwy|allyway|allwy
amble|ambl
anchorage|ancg
approach|app|apch|appr
arterial|artl
artery|art|arty
back|bk
bank|bnk
basin|basn|bsn
bayou|byu|bayoo
beach|baech|bch|beech
belt|blt
bend|bnd
block|blk|blck
bluff|blf|bluf|bluffs
bottom|bot|bottm|btm|bttm
bottoms|bttms|btms|bottms
boundary|bdy
bowl|bl
brace|br|brce
branch|br|brnch|brch
brae|br
break|brk
bridge|bdge|br|brdg|bri|brg
broadway|bdwy|bway|bwy|brdway
brook|brk
brooks|brks
brow|brw
burg|bg
burgs|brgs
butte|btte|bte
bypass|bypa|byps|bps|byp
byway|bywy
canyon|cyn|cnyn
caravan|cvan|cvn|c van
causeway|csway|cswy|causewy|caus|cause|cway
center|centre|cetr|cntr|ctr|c|cen
centers|ctrs
centreway|cnwy
chase|ch|chas
circle|cir|circel
circles|cirs
circlet|clt
circuit|crct|circ|cct|cirt|ci|circt
circus|crcs|crc
claim|clm
cliff|clf
cliffs|clfs
close|cl|cls|clse
cluster|clr|clstr
colonnade|clde|clnde
common|cmmn|comm|cmn
commons|cmmns|cmns|comms
concord|cncd|cncrd
concession|conc
concourse|con|concs|concse|cnc
connection|cntn|cxn
connector|conr|cnctr|cntr
copse|cps
corner|cnr|crn|cor
corners|cnrs|crns|cors
corseo|cseo
corso|cso
course|crse
court|ct|crt
courts|crts|cts
courtyard|cyd|ctyd
cove|cov|ce|cv
creek|cr|crk
crescent|cr|cres|crs|crecent
crest|crst|cst
crief|crf
croft|cft
cross|cs|crss
crossing|crsg|xing|csg|x ing|x-ing
crossroad|crd|cross road|xroad|x-road|x road|xrd|x-rd|x rd
crossroads|cross roads|xrds
crossway|cowy|crwy|xway|xwy|x-way|x way|x-wy|xwy
cruiseway|cuwy|crwy
cul
cul de sac|cul-de-sac|culdesac|cds|cusac|csac
curve|cve|crv|crve|curv
cutting|cttg|ctg|cutt
dale|dle
dell
dene
deviation|devn
dip
distributor|dstr
divide|div
diversion|divers
down|dn
drive|dr|drv|dv|dve|d
driveway|drwy|dvwy|dwy|dway|drvwy
drove|drov
easement|esmt
edge|edg
elbow|elb
elm
end
entrance|ent|entr
esplanade|esp|espl
estate|est
estates|ests
exit
expressway|exp|expwy|expway|expy
extension|ex|ext|extn|exten
extensions|exts
fairway|fawy|fy
fall|fl
falls|fls
fare
farm|frm
farms|frms
fern
ferry|fry|fy
field|fld|fd
fields|flds|fds
fireline|fline|fire line|flne
firetrack|ftrk|fire track
firetrail|fit|fitr|fire trail
flat|fl|flt
follow|folw
footway|ftwy|foot way
ford|frd
foreshore|fshr|fore shore
formation|form|fmtn
freeway|frwy|fw|fwy|fway
front|frnt
frontage|frtg|fr
gap|gp
garden|gdn|grd|grdn
gardens|gdns|grds|grdns
gate|ga|gte
gates|gtes
gateway|gwy|gway|gtwy|gtway
glade|gl|gld|glde
glen|gln
grange|gra
green|grn|gn
ground|grnd
grounds|grnds
grove|gr|grv|grve|gro
gulch|glch
gully|gly
hanger|hngr
harbor|harbour|hbr|hrbr
harbors|hbrs
haven|hvn
head|hd
heads|hds
heath|hth
hill|hl
hills|hls
hollow|hllw
impasse|imp
inlet|inlt
interchange|intg|intchg|inter change
intersection|intn|inter section|intsctn
island|is|id|i|isl|isld
islands|iss|ids|islds
isle
junction|jct|jnc|jnct|jctn|jtn|junct|j
junctions|jcts
key|ky
keys|kys
knob
knoll|knol|knl
knolls|knls
ladder|ladr
lagoon|lagn|lgn|lagon
land
landing|ldg|lndg|landng
laneway|lnwy
lees
light|lgt|lt
limits|lmts
line|ln
link|lnk|lk
little|ltl|lttl|littl|litl|lit|lt
loaf|lf
lookout|lkt|look out
loop|lp
loops|lps
lot|lt
lynne|lynn
mall|ml
manor|mnr
maze
meadow|mdw
meadows|mdws
mead|md
meander|mndr|mdr|mr
mew|mw
mews|mws
mile|mi
mill|ml
mills|mls
moor
motorway|mway|mwy|mtwy
neaves|nvs
nook|nk
oaks
outlet|otlt
outlook|out|otlk
oval
overbridge|ovrb|over bridge
overlook|over look|ovlk
overpass|over pass|opas
paddock|padk
palms|plms
parade|pde|prd|prde
parklands|pkld|pklds|parkland|park lands|park land
parkway|pkwy|parkwy|pky|pkway|prkwy|prkway|pkw|pwy
parkways|pkwys
part|prt
pass|ps
passage|psge|pass
path|pth
pathway|phwy|pway|pthway|pthwy|ptway|ptwy
peninsula|psla
piazza|piaz|pzza
pier
pike|pk
pine|pne|pn
pines|pns|pnes
pond
port|pt|prt
plain|pln|pl
plains|plns|pls
plateau|plat|plt
plaza|plz|plza|pz
prarie|pr
pocket|pkt|pokt|pckt
point|piont|pnt|pt
pointe|pte|pnte
port|prt
ports|prts
prairie|pr
priors|prrs
private|pvt
promenade|prom|prm
pursuit|pur
quad|qd
quadrangle|qdgl
quadrant|qdrt|qd
quay|quy|qy
quays|quys|qys
radial|radl
ramble|ra|rmbl
ramp|rmp
ranae|ran
ranch|rnch
rapid|rpd
rapids|rpds
range|rng|rnge|rang
reach|rch
reef
reserve|res|resrv|resv|rsrv|rserv|rserve|rsrve
rest|rst
retreat|rt|rtt
return|rtn
ride
ridge|rdge|rdg
ridges|rdgs
ridgeway|rgwy|rdgwy|ridge way
right of way|rowy|rightofway|rofw|row|r o w|r of w
ring
rise|ri
riverway|rvwy
riviera|rvra
roadside|rdsd|road side
roadway|rdwy|rdw|rdy
rocks|rks
ronde|rnde
rosebowl|rsbl|rose bowl
rotary|rty
round|rnd
roundabout
route|rt|rte
row|rw
run|rn
saint|st
sainte|ste
san|s
santa|sta
shoal|shl
shoals|shls
shore|shor|shr
shores|shors|shrs
shunt|shun|shnt
siding|sdng|sdg
skyway|skwy
slip
sound|snd
space|spc
spring|spg|sprng
spur|spr
square|sq|sqr
squares|sqs
stairs|strs
stairway|stwy|strwy|stair way|st.wy|st wy|str.way|str way
steps|stps
strand|stra|strnd|strd
strands|strnds|strds
strip|strp
subdivision|subdiv
subway|sbwy
summit|smt|sumt
tarn|tn
terrace|tce|ter|tr|terr|terace|terrac|terrasse|tsse
thicket|thick
thoroughfare|thor|throughfare|thorough fare|thfr
thoroughway|thwy
throughway|thru|thro|thruway|trwy
tollway|tlwy|twy
top
tor
tower|twr
towers|twrs
townline|tline
trace|trce
track|tr|trk|trak
trafficway|trfy
trail|tr|trl
trailer|trlr
tram
tramway|tmwy
trees|trs
trunkway|tkwy
tunnel|tun|tunl
turnabout|trnabt
turn|tn|trn
turnpike|tpk|tpke
underpass|upas|upass|ups|under pass
union|un
unions|uns
vale|va|vl
valley|vlly|vly|vy
valleys|vlys|vllys
vennel
viaduct|via|viad|vdct|viadct
view|vw
views|vws
vista|vst|vsta|vis
vue
walk|wlk|wk
walkway|wkwy|wky|wlkwy
waters|wtrs
well|wl
wells|wls
wharf|whrf|whf
woods|wds
wynd|wyn
yard|yd|yrd