allée|allee|all
allées|alls|allees
ancien chemin|ach|a ch
ancienne route|art
anciennes routes|arts
anse
arcade|arc
autoroute|aut
avenue|av|ave|aven|avenu|avn|avnu|avnue
avenues|avs|aves|avens|avenus|avns|avnus|avnues
barriêre|barriere|bre
barriêres|barrieres|bres
bas chemin|bch|b ch
berge|ber
berges|bers
bois
boucle|bcle
boulevard|bd|bde|blv|blvd|blvde|blvrd|boulavard|boul|boulv|bvd|boulevarde|bld
butte|but
côte|cote
côteau|coteau
cale
camp
campagne|cgne
carreau|cau|carru
carrefour|carf|carref
carrière|carriere|care
carrières|carrieres|cares
carré|carre|carr|car
cavée|cavee|cav
cercle|cercl
chalet|chl
champ
chaussée|chaussee|chs|chee
chaussées|chaussees|chss|chees
chemin|ch|che
chemin vicinal|chv|chev|ch v|che v
cheminement|chem
chemins|ches
chemins vicinaux|chsv|chs v
château|chateau|cht
cloître|cloitre|cloi
clos
col
contour|ctr
corniche|cor
corniches|cors
cour
cours|crs
degré|degre|deg
degrés|degres|degs
descente|dsg
descentes|dsgs
digue|dig
digues|digs
échangeur|éch
écluse|ecluse|ecl|écl
écluses|ecluses|ecls|écls
enclave|env
enclos|enc
espace|espa
esplanade|esp
esplanades|esps
fosse|fos
fosses|fos|foss
foyer|foyr
galerie|gal
galeries|gals
garenne|garn
grand boulevard|gbd|grbd|grdbd|gdbd|g bd|gr bd|grd bd|gd bd|g blvd|gr blvd|grd blvd|gd blvd|g bde|gr bde|grd bde|gd bde|g blvrd|gr blvrd|grd blvrd|gd blvrd|g boul|gr boul|grd boul|gd boul|g bvd|gr bvd|grd bvd|gd bvd|g bld|gr bld|grd bld|gd bld
grand chemin|gch|grch|gdch|grdch|g ch|gr ch|grd ch|gd ch|g chemin|gr chemin|grd chemin|gd chemin
grand ensemble|gden|gd en|g en|gr en|gdens|gd ens|g ens|gr ens
grand rue|grand'rue|grandrue|gr|grdr|gdr|g r|gr r|grd r|gd r|g rue|gr rue|grd rue|gd rue
grand rues|grs|g rs|gr rs|grd rs|gd rs|g rues|gr rues|grd rues|gd rues
grands ensembles|gdsen|gds ens|gs ens|grs ens|grds ens|gdsens
grille|gri
grimpette|grim
hameau|ham
haut chemin|hch|h ch
hauts chemins|hchs|h chs|hschs|hs chs
impasse|imp
impasses|imps
jetée|jetee|jte
jetées|jetees|jtes
levée|levee|leve|lve
montée|montee|mte
montées|montees|mtes
métro|metro|mét|met
nouvelle route|nte
parc|prc
parcs|prcs
parvis|prv
passage|pas|psg
passage à niveau|passage a niveau|pn|p.n.|p.n|p n
passe|pass
passerelle|ple
passerelles|ples
passes
patio|pat
périphérique|peripherique|peri|péri
petit chemin|p ch|p chemin|pt ch|pt chemin
petite allée|petite allee|pta|pt a|pt allee|p a|p allee
petite avenue|pae|pt ae|pt ave|p ave|pt avn|p avn
petite impasse|pim|p im|pt im|p impasse|pt impasse
petite route|prt|p rt|pt rt|p route|pt route|p rte|pt rte
petite rue|ptr|pt r|p rue|pt rue
petite allées|petites allees|ptas|pt as|pt allees|p a|p allees
place|pl
placis|plci
plage|plag
plages|plags
plaine|pln
plan
plateau|plt|plat
plateaux|pltx|platx
pointe|pte|pnte
pont
ponts
portique|porq|portq
portiques|porqs|portqs
pourtour|pour
presqu’île|presquîle|presqu'ile|presquile|prq|prql
promenade|prom
peripherique|peri
quai|au
raccourci|rac|racc
raidillon|raid
rampe|rpe|rmpe|rmp
rang
rempart|rem|remp
rocade|rocd
ronde|rnde
rond point|rondpoint|rdpt|rd pt|rpt
roquet|roqt
rotonde|rtd|rtnd|rtde|rtnde
route|rt|rte
routes|rts|rtes
route nationale|rn|r.n.|r.n|r n
rue|r
ruelle|rle
ruelles|rles
rues|rs
residence|res
residences|ress
sente|sen
sentes|sens
sentier|sent
sentiers|sents
square|sq
terrain|terr|trn
terrasse|tsse
terrasses|tsses
terre plein|tpl|t pl|trpl|tr pl
terte|trt
tertes|trts
traverse|tra|trvs|trvrs
vallon|val
valée|vallee|val
venelle|ven
venelles|vens
via
vieille route|vte|v rt|vrt|v rte|vrte|v route|vroute
vieux chemin|vche|v che|vch|v ch|v chemin
voie|voi
voies|vois