awang|awg
bulatan
cerunan|crn
changkat|ckt
dalaman|dlm
dataran|dtr
dayang|dyg
denai
haji|hj
halaman|hlm
hilir|hlr
jalan|jln|jl
kampung|kampong|kg
laluan
laman|lmn
langgak|lgk
lapangan
lebuh|lbh|luh
lebuhraya|lebuh raya|lbh raya|l/raya|lbr
lengkok|lkk
lingkaran|lkr
lintang|ltg
lorong|lrg
medan|mdn
pengiran|pg
persiaran|psn|psrn
rapat
simpangan|spn
simpang|spg
sisiran|ssr
solok|slk
sungai|sngai|sg
taman|tmn
tepian|tpn
tingkat|tkt
